#.#.#.T###.####...M.
#..T...T..##.##T....
TT.TT..#....M...###.
T..#.#TM..##...##M..
#T..TT.#.T..M.##....